111111111111111111111111111111111
1000000CC000000000000CC0000E00001
10CC000000000111011100000000C0001
10000P001100000CC0000000C00011001
10000C00110001111111000000C011001
10000000CC00000000000000C00000001
111111111111111111111111111111111