11111111111111111111111111111111111111111111111111
10CC00000C0000000CC000000CC000C000000000011110E001
100001100C0001100C0011000CCC0P00000011000CC0000001
10C001100000011000001100C00000CC000011000000000001
100C00000C00000CC000000001111000000CCC000000111001
11111111111111111111111111111111111111111111111111